10 10
%##   $   
 # $#  &$#
*# D   $*#
&# %** %% 
*$&DDDDDD 
*$ #**$ $ 
*$ # $ *$ 
*$  $$### 
*****$%%%a
          