10 10
a   ##%   
 # D &&   
*#* * $  #
%#D   &  #
 #  ***  #
*  ***   #
*#####  DD
 ###    **
 ## $$$$$$
       ***