10 10
a#% ###$$$
%# D $$$ #
 #&&  DD  
*#*#& %%#$
 #  $ D  #
 ### $$$  
 # *******
 $$$     *
 ##      *
 $$$$$****